###################################
#.................................#
#.................................#
#.................................#
#......#...................#......#
#.................................#
#.................................#
#......#......#.....#......#......#
#.................................#
#.................................#
#.................................#
#......#......#.....#......#......#
#.................................#
#.................................#
#......#......#.....#......#......#
#.................................#
#.................................#
#.................................#
##############.......##############
##############.#...#.##############
##############.......##############
##############.......##############
##############.......##############
##############.#...#.##############
##############.......##############
##############.......##############
##############.......##############
##############.#...#.##############
##############.......##############
##############.......##############
##############.......##############
#################▒#################