#####################################################
#.................................. ................#
#...................................................#
#...................................................#
#...................................................#
#...................................................#
#...................................................#
#...................................................#
#...................................................#
#...................................................#
#...................................................#
#...................................................#
#...................................................#
#...................................................#
#...................................................#
#...................................................#
#...................................................#
#...................................................#
#...................................................#
#...................................................#
#...................................................#
#...................................................#
#######################▒▒############################ 
